11111111111111
100E000000C001
10001111100001
100011000P0001
11111111111111