1111111111111
100E000000C01
1000111110F01
100011000P001
1111111111111